11
***********
**xxxxxE***
**x***x*x**
*xx***xxx**
********x**
***********
xxxx*******
S*****x****
***********
***********
***********